Datatypes (KEYWORD1)
ArduinoBTmyRobotClass	KEYWORD1
ArduinoBTmyRobot	KEYWORD1
Methods and Functions (KEYWORD2)
confBluetooth	KEYWORD2
bluetoothEventListenner	KEYWORD2
leftWheel	KEYWORD2
rightWheel	KEYWORD2
comp1	KEYWORD2
comp2	KEYWORD2
comp3	KEYWORD2
comp4	KEYWORD2
moveWheels	KEYWORD2
stopWheels	KEYWORD2
implement	KEYWORD2
acctionEvent	KEYWORD2
Constants (LITERAL1)
CW	LITERAL1
CCW	LITERAL1
AHEAD	LITERAL1
BACKWARD	LITERAL1
RIGHT	LITERAL1
LEFT	LITERAL1
STOP	LITERAL1
C_PRESSED	LITERAL1
C_RELEASED	LITERAL1
ON	LITERAL1
OFF	LITERAL1
